level 1


0000000000
0000000000
0000000000


level 2


0000000000
0000110000
0000000000


level 3


0000000000
3333112222
0000000000
